11111111111111111111111111
1100010000CCCC000000111111
11110000001111111110000011
110000C00011C0000000000011
11000110001101111111100011
11CE011P00000111111C000011
11111111111111111111111111