11111111111
100C0001111
1E110P11111
11111111111