11111111111
100C0001111
1E11P011111
11111111111